aa – Qafár af
ab – аԥсшәа
ace – Acèh
ady – адыгабзэ
af – Afrikaans
ak – Akan
als – Alemannisch
alt – алтай тил
am – አማርኛ
ami – Pangcah
an – aragonés
ang – Ænglisc
anp – अंगिका
ar – العربية
arc – ܐܪܡܝܐ
ary – الدارجة
arz – مصرى
as – অসমীয়া
ast – asturianu
atj – Atikamekw
av – авар
avk – Kotava
awa – अवधी
ay – Aymar aru
az – azərbaycanca
azb – تۆرکجه
ba – башҡортса
ban – Basa Bali
bar – Boarisch
bat-smg – žemaitėška
bcl – Bikol Central
be – беларуская
be-tarask – беларуская (тарашкевіца)
be-x-old – беларуская (тарашкевіца)
bg – български
bh – भोजपुरी
bi – Bislama
bjn – Banjar
blk – ပအိုဝ်ႏဘာႏသာႏ
bm – bamanankan
bn – বাংলা
bo – བོད་ཡིག
bpy – বিষ্ণুপ্রিয়া মণিপুরী
br – brezhoneg
bs – bosanski
btm – Batak Mandailing
bug – Basa Ugi
bxr – буряад
ca – català
cbk-zam – Chavacano de Zamboanga
cdo – 閩東語 / Mìng-dĕ̤ng-ngṳ̄
ce – нохчийн
ceb – Cebuano
ch – Chamoru
cho – Chahta anumpa
chr – ᏣᎳᎩ
chy – Tsetsêhestâhese
ckb – کوردی
co – corsu
cr – Nēhiyawēwin / ᓀᐦᐃᔭᐍᐏᐣ
crh – qırımtatarca
cs – čeština
csb – kaszëbsczi
cu – словѣньскъ / ⰔⰎⰑⰂⰡⰐⰠⰔⰍⰟ
cv – чӑвашла
cy – Cymraeg
da – dansk
dag – dagbanli
de – Deutsch
din – Thuɔŋjäŋ
diq – Zazaki
dsb – dolnoserbski
dty – डोटेली
dv – ދިވެހިބަސް
dz – ཇོང་ཁ
ee – eʋegbe
el – Ελληνικά
eml – emiliàn e rumagnòl
en – English
eo – Esperanto
es – español
et – eesti
eu – euskara
ext – estremeñu
fa – فارسی
fat – mfantse
ff – Fulfulde
fi – suomi
fiu-vro – võro
fj – Na Vosa Vakaviti
fo – føroyskt
fr – français
frp – arpetan
frr – Nordfriisk
fur – furlan
fy – Frysk
ga – Gaeilge
gag – Gagauz
gan – 贛語
gcr – kriyòl gwiyannen
gd – Gàidhlig
gl – galego
glk – گیلکی
gn – Avañe'ẽ
gom – गोंयची कोंकणी / Gõychi Konknni
gor – Bahasa Hulontalo
got – 𐌲𐌿𐍄𐌹𐍃𐌺
gpe – Ghanaian Pidgin
gu – ગુજરાતી
guc – wayuunaiki
gur – farefare
guw – gungbe
gv – Gaelg
ha – Hausa
hak – 客家語/Hak-kâ-ngî
haw – Hawaiʻi
he – עברית
hi – हिन्दी
hif – Fiji Hindi
ho – Hiri Motu
hr – hrvatski
hsb – hornjoserbsce
ht – Kreyòl ayisyen
hu – magyar
hy – հայերեն
hyw – Արեւմտահայերէն
hz – Otsiherero
ia – interlingua
id – Bahasa Indonesia
ie – Interlingue
ig – Igbo
ii – ꆇꉙ
ik – Iñupiatun
ilo – Ilokano
inh – гӀалгӀай
io – Ido
is – íslenska
it – italiano
iu – ᐃᓄᒃᑎᑐᑦ / inuktitut
ja – 日本語
jam – Patois
jbo – la .lojban.
jv – Jawa
ka – ქართული
kaa – Qaraqalpaqsha
kab – Taqbaylit
kbd – адыгэбзэ
kbp – Kabɩyɛ
kcg – Tyap
kg – Kongo
ki – Gĩkũyũ
kj – Kwanyama
kk – қазақша
kl – kalaallisut
km – ភាសាខ្មែរ
kn – ಕನ್ನಡ
ko – 한국어
koi – перем коми
kr – kanuri
krc – къарачай-малкъар
ks – कॉशुर / کٲشُر
ksh – Ripoarisch
ku – kurdî
kv – коми
kw – kernowek
ky – кыргызча
la – Latina
lad – Ladino
lb – Lëtzebuergesch
lbe – лакку
lez – лезги
lfn – Lingua Franca Nova
lg – Luganda
li – Limburgs
lij – Ligure
lld – Ladin
lmo – lombard
ln – lingála
lo – ລາວ
lrc – لۊری شومالی
lt – lietuvių
ltg – latgaļu
lv – latviešu
mad – Madhurâ
mai – मैथिली
map-bms – Basa Banyumasan
mdf – мокшень
mg – Malagasy
mh – Ebon
mhr – олык марий
mi – Māori
min – Minangkabau
mk – македонски
ml – മലയാളം
mn – монгол
mni – ꯃꯤꯇꯩ ꯂꯣꯟ
mnw – ဘာသာ မန်
mo – молдовеняскэ
mr – मराठी
mrj – кырык мары
ms – Bahasa Melayu
mt – Malti
mus – Mvskoke
mwl – Mirandés
my – မြန်မာဘာသာ
myv – эрзянь
mzn – مازِرونی
na – Dorerin Naoero
nah – Nāhuatl
nap – Napulitano
nds – Plattdüütsch
nds-nl – Nedersaksies
ne – नेपाली
new – नेपाल भाषा
ng – Oshiwambo
nia – Li Niha
nl – Nederlands
nn – norsk nynorsk
no – norsk
nov – Novial
nqo – ߒߞߏ
nrm – Nouormand
nso – Sesotho sa Leboa
nv – Diné bizaad
ny – Chi-Chewa
oc – occitan
olo – livvinkarjala
om – Oromoo
or – ଓଡ଼ିଆ
os – ирон
pa – ਪੰਜਾਬੀ
pag – Pangasinan
pam – Kapampangan
pap – Papiamentu
pcd – Picard
pcm – Naijá
pdc – Deitsch
pfl – Pälzisch
pi – पालि
pih – Norfuk / Pitkern
pl – polski
pms – Piemontèis
pnb – پنجابی
pnt – Ποντιακά
ps – پښتو
pt – português
pwn – pinayuanan
qu – Runa Simi
rm – rumantsch
rmy – romani čhib
rn – ikirundi
ro – română
roa-rup – armãneashti
roa-tara – tarandíne
ru – русский
rue – русиньскый
rw – Ikinyarwanda
sa – संस्कृतम्
sah – саха тыла
sat – ᱥᱟᱱᱛᱟᱲᱤ
sc – sardu
scn – sicilianu
sco – Scots
sd – سنڌي
se – davvisámegiella
sg – Sängö
sh – srpskohrvatski / српскохрватски
shi – Taclḥit
shn – ၽႃႇသႃႇတႆး 
shy – tacawit
si – සිංහල
simple – Simple English
sk – slovenčina
skr – سرائیکی
sl – slovenščina
sm – Gagana Samoa
smn – anarâškielâ
sn – chiShona
so – Soomaaliga
sq – shqip
sr – српски / srpski
srn – Sranantongo
ss – SiSwati
st – Sesotho
stq – Seeltersk
su – Sunda
sv – svenska
sw – Kiswahili
szl – ślůnski
szy – Sakizaya
ta – தமிழ்
tay – Tayal
tcy – ತುಳು
te – తెలుగు
tet – tetun
tg – тоҷикӣ
th – ไทย
ti – ትግርኛ
tk – Türkmençe
tl – Tagalog
tn – Setswana
to – lea faka-Tonga
tpi – Tok Pisin
tr – Türkçe
trv – Seediq
ts – Xitsonga
tt – татарча / tatarça
tum – chiTumbuka
tw – Twi
ty – reo tahiti
tyv – тыва дыл
udm – удмурт
ug – ئۇيغۇرچە / Uyghurche
uk – українська
ur – اردو
uz – oʻzbekcha / ўзбекча
ve – Tshivenda
vec – vèneto
vep – vepsän kel’
vi – Tiếng Việt
vls – West-Vlams
vo – Volapük
wa – walon
war – Winaray
wo – Wolof
wuu – 吴语
xal – хальмг
xh – isiXhosa
xmf – მარგალური
yi – ייִדיש
yo – Yorùbá
yue – 粵語
za – Vahcuengh
zea – Zeêuws
zh – 中文
zh-classical – 文言
zh-min-nan – Bân-lâm-gú
zh-yue – 粵語
zu – isiZulu